####################
#S   #      #     E#
# ## # #### # ######
#    #    # #      #
#### ###  # #  #####
#      #  # #  #   #
#  #######  #  #   #
#        #  #  #####
######   #  #      #
####################
